13 13 13 13 13 13 13 13 13 13 13 13 13 13 13 13 13 13 13 13 13 13 13 13 13 13 13 13 13 13 13 13 13 13 13 13 13 13 13 13 13 13 13 13 13 13 13 13 13 13
13 13 13 13 13 13 13 13 13 13 13 13 13 13 13 13 13 13 13 13 13 13 13 13 13 13 13 13 13 13 13 13 13 13 13 13 13 13 13 13 13 13 13 13 13 13 13 13 13 13
13 13 13 0 0 0 0 0 17 0 0 0 0 0 0 0 0 9 4 4 4 4 4 4 4 4 4 4 4 10 13 13 13 13 13 0 0 0 0 0 0 0 0 0 0 0 13 13 13 13
13 13 0 0 0 0 0 0 0 0 0 0 0 0 0 0 9 2 2 2 2 2 2 2 2 2 2 2 2 2 10 13 13 13 0 0 0 0 0 0 0 0 0 0 0 0 0 13 13 13
13 0 0 19 1 1 1 1 1 1 21 0 0 0 9 4 2 2 2 2 2 2 2 2 2 2 2 2 2 2 6 13 13 0 0 19 1 1 1 1 1 1 1 1 1 21 0 0 13 13
13 0 0 1 26 11 11 11 11 28 1 0 0 0 5 2 2 2 2 2 2 2 2 2 2 2 2 2 2 2 6 13 13 0 0 1 26 11 11 11 11 11 11 11 28 1 0 0 13 13
13 0 0 1 11 11 11 11 11 11 1 0 0 0 5 2 2 2 2 2 2 2 2 2 2 2 2 2 2 2 6 13 13 0 0 1 11 11 11 11 11 11 11 11 11 1 0 0 13 13
13 14 0 1 25 11 11 11 11 27 1 0 0 0 5 2 2 2 2 2 2 2 2 2 2 2 2 2 2 2 6 13 13 0 0 1 25 11 11 11 11 11 11 11 27 1 0 0 13 13
13 18 0 20 1 24 11 23 1 1 22 0 0 0 5 2 2 2 2 2 2 2 2 2 2 2 2 2 2 2 6 13 13 0 0 20 1 1 1 24 11 11 23 1 1 22 0 0 13 13
13 0 0 0 13 13 12 13 13 13 0 0 0 0 7 2 2 2 2 2 2 2 2 2 2 2 2 2 2 3 8 13 13 0 0 0 13 13 13 13 12 12 13 13 13 13 0 0 13 13
13 0 0 0 0 13 0 13 0 0 0 0 0 14 0 7 3 2 2 2 2 2 2 2 2 2 2 3 8 12 0 13 13 13 0 17 0 0 0 0 0 0 0 0 0 0 0 0 13 13
13 0 0 0 0 0 0 0 0 0 0 0 0 0 0 0 0 7 3 3 3 3 3 2 2 2 8 12 12 39 0 13 13 13 13 13 0 0 0 0 0 17 0 0 0 0 18 13 13 13
13 0 0 0 0 0 0 0 0 0 15 0 0 0 0 0 0 0 38 12 12 12 12 7 3 8 12 39 0 0 13 13 13 13 13 13 13 0 0 0 12 0 0 0 13 13 13 13 13 13
13 0 15 0 0 0 12 0 0 0 0 0 0 0 15 0 0 0 0 15 0 0 38 12 12 12 39 0 0 13 13 13 13 13 13 13 13 0 0 0 12 40 0 0 13 13 13 13 13 13
13 0 0 0 0 0 38 40 0 0 17 0 0 13 13 0 0 0 0 0 0 14 14 14 0 0 0 0 13 13 13 13 13 13 13 13 13 13 0 0 12 12 0 13 13 13 13 13 13 13
13 0 0 15 0 0 0 38 40 0 0 0 0 0 17 0 0 15 15 0 17 0 14 14 0 0 0 0 13 13 13 13 13 13 13 13 13 13 13 0 12 12 0 13 13 13 13 13 13 13
13 0 0 0 0 0 0 0 38 40 0 0 0 0 0 0 0 15 15 15 0 0 0 0 0 12 0 13 13 13 13 13 13 13 13 13 13 13 0 0 12 12 0 13 13 13 13 13 13 13
13 0 14 0 0 0 0 0 0 38 40 0 0 15 0 0 0 0 0 0 0 0 15 0 0 12 0 13 13 13 13 13 13 13 13 13 13 13 0 37 12 39 0 0 13 13 13 13 13 13
13 0 0 0 0 0 0 15 0 0 38 40 0 0 0 0 0 0 17 0 0 0 0 0 0 12 0 0 13 13 13 13 13 13 13 13 13 0 0 12 12 0 0 0 13 13 13 13 13 13
13 0 13 13 0 0 0 17 0 0 0 12 12 40 0 0 0 0 0 0 0 0 14 0 37 12 0 0 0 13 13 13 13 13 13 13 0 0 37 12 39 0 0 13 13 13 13 13 13 13
13 0 0 15 0 0 0 0 0 0 0 0 38 12 12 12 12 12 12 12 12 12 12 12 12 12 40 0 0 0 0 0 0 0 0 0 0 37 12 39 0 0 0 13 13 13 13 13 13 13
13 0 0 0 0 17 0 0 0 14 0 0 0 0 0 0 0 0 0 0 0 0 0 0 38 12 12 12 12 12 12 12 12 12 12 12 12 12 39 0 0 0 13 13 13 13 13 13 13 13
13 0 0 0 0 0 0 0 0 0 0 0 0 0 0 0 0 0 0 0 0 0 0 0 0 12 39 0 0 0 0 15 0 0 0 0 13 13 0 0 0 0 13 13 13 13 13 13 13 13
13 0 0 14 0 0 0 0 0 0 0 18 0 0 0 17 0 0 0 0 17 0 0 0 0 12 0 0 13 0 0 0 0 0 0 0 14 0 0 0 0 0 13 13 13 13 13 13 13 13
13 0 0 0 0 0 0 16 0 0 0 0 0 0 0 0 0 0 0 0 0 0 0 0 0 12 0 0 0 0 0 0 14 0 0 0 0 0 0 15 0 0 13 13 13 13 13 13 13 13
13 0 0 0 15 0 0 0 0 0 0 14 0 19 1 1 1 1 1 1 1 21 0 0 0 12 0 0 0 0 0 0 0 0 0 0 0 0 0 0 0 0 0 13 13 13 13 13 13 13
13 17 0 0 0 0 0 0 0 0 0 0 0 1 26 11 11 11 11 11 28 1 0 0 0 12 0 0 0 0 0 15 0 0 0 0 0 14 0 0 0 0 0 13 13 13 13 13 13 13
13 0 0 0 0 0 0 0 0 13 13 0 0 1 11 11 11 11 11 11 11 1 0 0 0 12 0 0 0 0 0 0 0 0 0 0 0 0 0 0 0 0 0 0 13 13 13 13 13 13
13 0 17 0 0 0 0 0 0 0 0 0 0 1 25 11 11 11 11 11 27 1 0 0 0 12 0 0 0 0 0 0 0 0 0 0 0 0 13 13 0 0 0 0 0 13 13 13 13 13
13 0 0 0 0 13 13 0 0 0 0 0 0 20 1 1 24 11 23 1 1 22 0 0 0 12 0 0 0 0 0 0 0 0 0 0 0 0 0 0 0 0 0 0 0 0 13 13 13 13
13 0 14 0 0 0 0 0 0 0 0 14 0 0 13 13 13 0 13 13 13 0 0 0 0 12 40 0 0 0 0 0 0 0 0 0 0 0 0 0 0 0 0 0 0 0 0 13 13 13
13 0 0 0 0 0 0 14 0 0 0 0 0 14 0 0 0 12 0 0 0 0 0 14 0 12 12 12 12 12 12 12 40 0 0 0 0 0 0 19 1 1 1 1 1 21 0 0 13 13
13 0 0 0 0 37 12 12 12 40 0 0 0 0 0 0 0 12 0 0 0 0 0 0 0 12 39 0 0 0 0 38 12 40 0 0 0 0 0 1 26 11 11 11 28 1 0 0 13 13
13 0 0 0 0 12 0 0 0 38 12 12 12 12 12 40 0 12 40 0 0 0 0 0 37 12 0 0 0 15 0 0 38 12 40 0 0 0 0 35 11 11 11 11 11 1 0 0 13 13
13 0 0 0 13 0 13 13 13 13 13 0 0 0 0 38 12 12 12 12 12 12 12 12 12 39 0 0 0 0 0 0 0 38 12 12 12 0 0 11 11 11 11 11 11 1 0 0 13 13
13 0 0 19 35 11 34 1 1 1 1 1 21 0 0 0 0 15 0 0 0 0 0 0 0 0 0 0 13 0 0 0 0 0 0 0 0 0 0 24 25 11 11 11 27 1 0 0 13 13
13 0 13 1 11 11 11 11 11 11 11 28 1 0 0 0 0 0 0 0 0 0 0 17 0 0 0 13 13 13 0 0 15 0 0 0 0 0 0 20 1 1 1 1 1 22 0 0 13 13
13 0 13 1 11 11 11 11 11 11 11 11 1 0 0 0 0 15 15 0 0 0 0 0 0 14 0 0 0 0 0 0 0 0 0 0 0 0 0 0 0 0 0 0 17 0 0 0 13 13
13 0 13 1 11 11 11 11 11 11 11 11 1 0 0 0 0 0 0 0 0 0 0 0 0 0 0 0 0 15 15 0 0 0 0 0 0 0 0 17 0 0 0 0 0 0 18 0 13 13
13 0 13 1 25 11 11 11 11 11 11 27 1 0 0 0 0 13 13 0 0 0 14 0 0 0 0 15 0 0 17 0 0 0 0 0 14 0 0 0 0 0 0 0 0 0 0 0 13 13
13 0 0 20 1 1 1 1 1 1 1 1 22 0 0 0 0 13 0 0 0 0 0 0 0 0 0 0 0 0 0 0 0 0 0 0 0 0 0 0 0 0 0 0 0 0 0 0 13 13
13 17 0 0 0 0 0 0 14 0 0 0 0 0 0 0 0 0 17 0 0 0 0 15 0 0 0 0 0 0 0 0 0 0 0 0 13 13 18 0 0 15 15 0 0 0 0 0 13 13
13 0 0 0 0 18 0 0 13 0 0 0 0 15 0 0 0 0 0 0 0 0 0 0 9 4 4 4 4 10 0 0 0 0 0 0 0 0 0 0 0 0 9 4 4 4 4 4 4 4
13 0 0 0 15 0 0 0 0 0 0 0 0 0 0 15 0 0 17 0 0 0 0 9 2 2 2 2 2 2 4 10 0 0 0 0 0 0 0 0 9 4 2 2 2 2 2 2 2 2
4 4 4 4 4 4 4 4 4 4 4 4 4 4 4 10 0 0 0 0 0 0 9 2 2 2 2 2 2 2 2 2 4 10 0 0 0 0 9 4 2 2 2 2 2 2 2 2 2 2
2 2 2 2 2 2 2 2 2 2 2 2 2 2 2 2 4 4 4 4 4 4 2 2 2 2 3 3 3 2 2 2 2 2 4 4 4 4 2 2 2 2 3 3 3 3 3 3 3 3
2 2 2 2 2 2 2 2 2 2 2 2 2 2 2 2 2 2 2 2 2 2 2 2 2 8 0 0 0 7 2 2 2 2 2 2 2 2 2 2 2 6 0 0 0 0 0 0 13 13
3 3 3 3 3 3 3 3 3 3 3 3 3 3 3 2 2 2 2 2 2 2 2 3 8 0 0 0 0 0 7 2 2 2 2 2 2 2 3 3 8 0 0 0 0 0 0 13 13 13
13 13 13 0 0 0 0 0 0 0 0 0 0 0 0 7 3 3 3 3 3 3 8 0 0 0 0 0 0 0 0 7 3 3 3 3 3 8 0 0 0 0 0 0 0 0 13 13 13 13
13 13 13 13 13 13 13 13 13 13 13 13 13 13 13 13 13 13 13 13 13 13 13 13 13 13 13 13 13 13 13 13 13 13 13 13 13 13 13 13 13 13 13 13 13 13 13 13 13 13