0 0 0 0 0 0 0 0 0 0 0 0 0 0 0 0
0 0 0 0 0 0 0 0 0 0 0 0 0 0 0 0
0 0 0 0 0 0 0 0 0 0 0 0 0 0 0 0
0 0 0 0 0 0 0 0 9 4 10 0 0 0 0 0
0 0 0 0 0 0 0 9 2 2 2 4 10 0 0 0
0 0 0 0 0 0 0 7 2 2 2 2 2 10 0 0
0 0 0 0 0 0 0 0 7 2 2 2 3 8 0 0
0 0 0 0 0 0 0 0 0 7 3 8 0 0 0 0
1 1 1 1 0 0 1 1 0 0 0 0 0 0 0 0
1 0 0 0 0 0 0 1 0 0 0 0 0 0 0 0
1 0 0 0 0 0 0 1 0 0 0 0 0 0 0 0
1 1 1 1 1 1 1 1 0 0 0 0 0 0 0 0