13 13 13 13 13 13 13 13 13 13 13 13 13 13 13 13 13 13 13 13 13 13 13 13 13 13 13 13 13 13 13 13 13 13 13 13 13 13 13 13 13 13 13 13 13 13 13 13 13 13
13 13 13 13 13 13 13 13 13 13 13 13 13 13 13 13 13 13 13 13 13 13 13 13 13 13 13 13 13 13 13 13 13 13 13 13 13 13 13 13 13 13 13 13 13 13 13 13 13 13
13 13 13 0 0 0 0 0 0 0 0 0 0 0 0 0 0 9 4 4 4 4 4 4 4 4 4 4 4 10 13 13 13 13 13 0 0 0 0 0 0 0 0 0 0 0 13 13 13 13
13 13 0 0 0 0 0 0 0 0 0 0 0 0 0 0 9 2 2 2 2 2 2 2 2 2 2 2 2 2 10 13 13 13 0 0 0 0 0 0 0 0 0 0 0 0 0 13 13 13
13 0 0 1 1 1 1 1 1 1 1 0 0 0 9 4 2 2 2 2 2 2 2 2 2 2 2 2 2 2 6 13 13 0 0 1 1 1 1 1 1 1 1 1 1 1 0 0 13 13
13 0 0 1 11 11 11 11 11 11 1 0 0 0 5 2 2 2 2 2 2 2 2 2 2 2 2 2 2 2 6 13 13 0 0 1 11 11 11 11 11 11 11 11 11 1 0 0 13 13
13 0 0 1 11 11 11 11 11 11 1 0 0 0 5 2 2 2 2 2 2 2 2 2 2 2 2 2 2 2 6 13 13 0 0 1 11 11 11 11 11 11 11 11 11 1 0 0 13 13
13 0 0 1 11 11 11 11 11 11 1 0 0 0 5 2 2 2 2 2 2 2 2 2 2 2 2 2 2 2 6 13 13 0 0 1 11 11 11 11 11 11 11 11 11 1 0 0 13 13
13 0 0 1 1 1 11 1 1 1 1 0 0 0 5 2 2 2 2 2 2 2 2 2 2 2 2 2 2 2 6 13 13 0 0 1 1 1 1 1 11 11 1 1 1 1 0 0 13 13
13 0 0 0 13 13 12 13 13 13 0 0 0 0 7 2 2 2 2 2 2 2 2 2 2 2 2 2 2 3 8 13 13 0 0 0 13 13 13 13 12 12 13 13 13 13 0 0 13 13
13 0 0 0 0 13 0 13 0 0 0 0 0 0 0 7 3 2 2 2 2 2 2 2 2 2 2 3 8 12 0 13 13 13 0 0 0 0 0 0 0 0 0 0 0 0 0 0 13 13
13 0 0 0 0 0 0 0 0 0 0 0 0 0 0 0 0 7 3 3 3 3 3 2 2 2 8 12 12 12 0 13 13 13 13 13 0 0 0 0 0 0 0 0 0 0 0 13 13 13
13 0 0 0 0 0 0 0 0 0 0 0 0 0 0 0 0 0 12 12 12 12 12 7 3 8 12 12 0 0 13 13 13 13 13 13 13 0 0 0 12 0 0 0 13 13 13 13 13 13
13 0 0 0 0 0 12 0 0 0 0 0 0 0 0 0 0 0 0 0 0 0 12 12 12 12 12 0 0 13 13 13 13 13 13 13 13 0 0 0 12 12 0 0 13 13 13 13 13 13
13 0 0 0 0 0 12 12 0 0 0 0 0 0 0 0 0 0 0 0 0 0 0 0 0 0 0 0 13 13 13 13 13 13 13 13 13 13 0 0 12 12 0 13 13 13 13 13 13 13
13 0 0 0 0 0 0 12 12 0 0 0 0 0 0 0 0 0 0 0 0 0 0 0 0 0 0 0 13 13 13 13 13 13 13 13 13 13 13 0 12 12 0 13 13 13 13 13 13 13
13 0 0 0 0 0 0 0 12 12 0 0 0 0 0 0 0 0 0 0 0 0 0 0 0 12 0 13 13 13 13 13 13 13 13 13 13 13 0 0 12 12 0 13 13 13 13 13 13 13
13 0 0 0 0 0 0 0 0 12 12 0 0 0 0 0 0 0 0 0 0 0 0 0 0 12 0 13 13 13 13 13 13 13 13 13 13 13 0 12 12 12 0 0 13 13 13 13 13 13
13 0 0 0 0 0 0 0 0 0 12 12 0 0 0 0 0 0 0 0 0 0 0 0 0 12 0 0 13 13 13 13 13 13 13 13 13 0 0 12 12 0 0 0 13 13 13 13 13 13
13 0 0 0 0 0 0 0 0 0 0 12 12 12 0 0 0 0 0 0 0 0 0 0 12 12 0 0 0 13 13 13 13 13 13 13 0 0 12 12 12 0 0 13 13 13 13 13 13 13
13 0 0 0 0 0 0 0 0 0 0 0 12 12 12 12 12 12 12 12 12 12 12 12 12 12 12 0 0 0 0 0 0 0 0 0 0 12 12 12 0 0 0 13 13 13 13 13 13 13
13 0 0 0 0 0 0 0 0 0 0 0 0 0 0 0 0 0 0 0 0 0 0 0 12 12 12 12 12 12 12 12 12 12 12 12 12 12 12 0 0 0 13 13 13 13 13 13 13 13
13 0 0 0 0 0 0 0 0 0 0 0 0 0 0 0 0 0 0 0 0 0 0 0 0 12 12 0 0 0 0 0 0 0 0 0 0 0 0 0 0 0 13 13 13 13 13 13 13 13
13 0 0 0 0 0 0 0 0 0 0 0 0 0 0 0 0 0 0 0 0 0 0 0 0 12 0 0 0 0 0 0 0 0 0 0 0 0 0 0 0 0 13 13 13 13 13 13 13 13
13 0 0 0 0 0 0 0 0 0 0 0 0 0 0 0 0 0 0 0 0 0 0 0 0 12 0 0 0 0 0 0 0 0 0 0 0 0 0 0 0 0 13 13 13 13 13 13 13 13
13 0 0 0 0 0 0 0 0 0 0 0 0 1 1 1 1 1 1 1 1 1 0 0 0 12 0 0 0 0 0 0 0 0 0 0 0 0 0 0 0 0 0 13 13 13 13 13 13 13
13 0 0 0 0 0 0 0 0 0 0 0 0 1 11 11 11 11 11 11 11 1 0 0 0 12 0 0 0 0 0 0 0 0 0 0 0 0 0 0 0 0 0 13 13 13 13 13 13 13
13 0 0 0 0 0 0 0 0 0 0 0 0 1 11 11 11 11 11 11 11 1 0 0 0 12 0 0 0 0 0 0 0 0 0 0 0 0 0 0 0 0 0 0 13 13 13 13 13 13
13 0 0 0 0 0 0 0 0 0 0 0 0 1 11 11 11 11 11 11 11 1 0 0 0 12 0 0 0 0 0 0 0 0 0 0 0 0 0 0 0 0 0 0 0 13 13 13 13 13
13 0 0 0 0 0 0 0 0 0 0 0 0 1 1 1 1 11 1 1 1 1 0 0 0 12 0 0 0 0 0 0 0 0 0 0 0 0 0 0 0 0 0 0 0 0 13 13 13 13
13 0 0 0 0 0 0 0 0 0 0 0 0 0 13 13 13 0 13 13 13 0 0 0 0 12 12 0 0 0 0 0 0 0 0 0 0 0 0 0 0 0 0 0 0 0 0 13 13 13
13 0 0 0 0 0 0 0 0 0 0 0 0 0 0 0 0 12 0 0 0 0 0 0 0 12 12 12 12 12 12 12 12 0 0 0 0 0 0 1 1 1 1 1 1 1 0 0 13 13
13 0 0 0 12 12 12 12 12 12 0 0 0 0 0 0 0 12 0 0 0 0 0 0 0 12 12 0 0 0 0 12 12 12 0 0 0 0 0 1 11 11 11 11 11 1 0 0 13 13
13 0 0 0 12 0 0 0 0 12 12 12 12 12 12 12 0 12 12 0 0 0 0 0 12 12 0 0 0 0 0 0 12 12 12 0 0 0 0 1 11 11 11 11 11 1 0 0 13 13
13 0 13 0 0 0 13 13 13 13 13 0 0 0 0 12 12 12 12 12 12 12 12 12 12 12 0 0 0 0 0 0 0 12 12 12 12 0 0 11 11 11 11 11 11 1 0 0 13 13
13 0 13 1 11 1 1 1 1 1 1 1 1 0 0 0 0 0 0 0 0 0 0 0 0 0 0 0 0 0 0 0 0 0 0 0 0 0 0 1 11 11 11 11 11 1 0 0 13 13
13 0 13 1 11 11 11 11 11 11 11 11 1 0 0 0 0 0 0 0 0 0 0 0 0 0 0 0 0 0 0 0 0 0 0 0 0 0 0 1 1 1 1 1 1 1 0 0 13 13
13 0 13 1 11 11 11 11 11 11 11 11 1 0 0 0 0 0 0 0 0 0 0 0 0 0 0 0 0 0 0 0 0 0 0 0 0 0 0 0 0 0 0 0 0 0 0 0 13 13
13 0 13 1 11 11 11 11 11 11 11 11 1 0 0 0 0 0 0 0 0 0 0 0 0 0 0 0 0 0 0 0 0 0 0 0 0 0 0 0 0 0 0 0 0 0 0 0 13 13
13 0 13 1 11 11 11 11 11 11 11 11 1 0 0 0 0 0 0 0 0 0 0 0 0 0 0 0 0 0 0 0 0 0 0 0 0 0 0 0 0 0 0 0 0 0 0 0 13 13
13 0 0 1 1 1 1 1 1 1 1 1 1 0 0 0 0 0 0 0 0 0 0 0 0 0 0 0 0 0 0 0 0 0 0 0 0 0 0 0 0 0 0 0 0 0 0 0 13 13
13 0 0 0 0 0 0 0 0 0 0 0 0 0 0 0 0 0 0 0 0 0 0 0 0 0 0 0 0 0 0 0 0 0 0 0 0 0 0 0 0 0 0 0 0 0 0 0 13 13
13 0 0 0 0 0 0 0 0 0 0 0 0 0 0 0 0 0 0 0 0 0 0 0 9 4 4 4 4 4 10 0 0 0 0 0 0 0 0 0 0 0 9 4 4 4 4 4 4 4
13 0 0 0 0 0 0 0 0 0 0 0 0 0 0 0 0 0 0 0 0 0 0 9 2 2 2 2 2 2 2 10 0 0 0 0 0 0 0 0 9 4 2 2 2 2 2 2 2 2
4 4 4 4 4 4 4 4 4 4 4 4 4 4 4 10 0 0 0 0 0 0 9 2 2 2 2 2 2 2 2 2 10 0 0 0 0 0 9 4 2 2 2 2 2 2 2 2 2 2
2 2 2 2 2 2 2 2 2 2 2 2 2 2 2 2 4 4 4 4 4 4 2 2 2 2 3 3 3 2 2 2 2 2 4 4 4 4 2 2 2 2 3 3 3 3 3 3 3 3
2 2 2 2 2 2 2 2 2 2 2 2 2 2 2 2 2 2 2 2 2 2 2 2 2 6 0 0 0 5 2 2 2 2 2 2 2 2 2 2 2 6 0 0 0 0 0 0 13 13
3 3 3 3 3 3 3 3 3 3 3 3 3 3 3 2 2 2 2 2 2 2 2 3 8 0 0 0 0 0 7 2 2 2 2 2 2 2 3 3 8 0 0 0 0 0 0 13 13 13
13 13 13 0 0 0 0 0 0 0 0 0 0 0 0 7 3 3 3 3 3 3 8 0 0 0 0 0 0 0 0 7 3 3 3 3 3 8 0 0 0 0 0 0 0 0 13 13 13 13
13 13 13 13 13 13 13 13 13 13 13 13 13 13 13 13 13 13 13 13 13 13 13 13 13 13 13 13 13 13 13 13 13 13 13 13 13 13 13 13 13 13 13 13 13 13 13 13 13 13